10 30
|-----------------------|
|...|.F.........F...P...|
|.F.|...................|
|........F...|-----|....|
|...P........|..P.F|...P|
|........P......F.......|
|..F........@...........|
|...|.F.|...............|
|P......|....F....P.....|
|-----------------------|